{
    "maxRow":11,
    "maxCol":11,
    "clearColorNumCount" : 4,
    "trapColorNumCount" : 1,
    "minRange" : 10,
    "maxRange" : 15,
    "timer" : 75,
    "cells":[
                1,1,1,1,1,1,1,1,1,1,1
                1,1,1,1,1,1,1,1,1,1,1
                1,1,0,0,0,0,0,0,0,1,1
                1,1,0,1,1,1,1,1,0,1,1
                1,1,0,1,1,1,1,1,0,1,1
                1,1,0,1,1,1,1,1,0,1,1
                1,1,0,1,1,1,1,1,0,1,1
                1,1,0,1,1,1,1,1,0,1,1
                1,1,0,0,0,0,0,0,0,1,1
                1,1,1,1,1,1,1,1,1,1,1
                1,1,1,1,1,1,1,1,1,1,1
             ]
}
