{
    "maxRow":9,
    "maxCol":9,
    "clearColorNumCount" : 3,
    "trapColorNumCount" : 1,
    "cells":[
                0,1,1,1,1,1,1,1,0,
                1,0,1,1,1,1,1,0,1,
                1,1,0,1,1,1,0,1,1,
                1,1,1,0,1,0,1,1,1,
                1,1,1,0,0,0,1,1,1,
                1,1,1,0,1,0,1,1,1,
                1,1,0,1,1,1,0,1,1,
                1,0,1,1,1,1,1,0,1,
                0,1,1,1,1,1,1,1,0
             ]
}
